[nivel]
origen=terrenogen.png
al=12
an=32
mapa= #################################################################################################
      #...........C..............T.....................................................................
      #..................................................................C.....................X.......
      #..........................................................#.....................................
      #.......####################################################.....................................
      #..................a................a............a.........#.....................................
      #............................................a.....a.......#.....................................
      #............................................a.............#..................T..................
      ###################################################........#.....................................
      #..........C.......a..T................T...................#.....................................
      #........................................T.................#.....................................
      #................###########################################.....................................
      #................###########################################.....................................
      #................###########################################.....................................
      #................###########################################.....................................
      #................###########################################.....................................
      #................###########################################.....................................
      #................###########################################........C............................
      #................###########################################.....................................
      #................################################################################################
[.]
nom=pasto
x=17
y=9
muro=0

[#]
nom=bloque
x=9
y=9
muro=1

[a]
nom=agua
x=8
y=9
muro=0

[C]
origen='adds5.png'
x=17
y=9

[T]
x=8
y=9

[X]
x=8
y=9
