[nivel]
origen=terrenogen.png
al=12
an=32
mapa= #####################################################################################################################
      #.............T.....L.....................L.....................L.....................L.....................L.#######
      #...................................T..............T........................T.................................#######
      #..................a..........T...............................................................................#######
      #................................T.....................................T....T...a......a..a...................#######
      #..................a.........T......a............a............................................................#######
      #..........a....a............................a.....a..................T.....T.................................#######
      #...........................................a.............................................a...................#######
      #####################################################################################################.........#######
      #####################################################################################################.........#######
      #........................a..............a......................L......................L.......................#######
      #....................L....T...............L..................................T................................#######
      #..........a................T...........................................T.......T.............................#######
      #....................................................T........................................................#######
      #.............................................................................................................#######
      #..l.............####################################################################################################
      #................####################################################################################################
      #...................L..............T......L......T..............L.....................L.........#####################
      #...............................................................................................#####################
      #..............................T....C..T..............T............................T............#####################
      #...................................C...........................................................#####################
      #.............................C.C...............................................................#####################
      ##############################...#########################################################......#####################
      ##############################.O.###.O.##########.....................................L.........#####################
      ####################################...##########...............................................#####################
      #.............T..............a..........C.L#.....................#......................C.......#####################
      #.........a......................C..C.....##.....................#..............C...............#####################
      #..............T..T...T.......a....a......##.....................#........................C.....#####################
      #...................................a.....##.....................#..C...........................#####################
      #.........................................##.....................#..........................C...#####################
      #...########################################.....................####################################################
      #..l########################################....................L####################################################
      #.C........................................#.....................####################################################
      #........................a.................#....C................####################################################
      #..........................................#.........C...........####################################################
      #......##################################..#.................C...####################################################
      #......##################################..#.............C.......####################################################
      #......................................##..#...C.................####################################################
      #..............C.......................##..#.............C...C...####################################################
      #..........T......C....................##..#.....................####################################################
      #.................................X....##..#..C..C..C............####################################################
      #..........T...C.......................##.........O.......C......####################################################
      #......................................##........................####################################################
      #......................................##############################################################################
      #.............T........................##############################################################################
      #......................................##############################################################################
      #......................................##############################################################################
      #####################################################################################################################
[.]
nom=pasto
x=17
y=9
muro=0

[#]
nom=bloque
x=9
y=9
muro=1

[a]
nom=agua
x=8
y=9
muro=0

[C]
origen='adds5.png'
x=17
y=9

[O]
x=17
y=9

[T]
x=8
y=9

[X]
x=8
y=9
[l]
x=18
y=9
[L]
x=18
y=9
